111111111111111111111111111111111111111111111111
100000000000000000000001122222222222222222222221
100000000000000000000001122222222222222222222221
100000011111111110000001122222211111111112222221
100000010000000010000001122222212222222212222221
100000000000000000000001122222222222222222222221
100000000000000000000001122222222222222222222221
100000000000000000000001122222222222222222222221
100010000000000000010001122212222222222222212221
100000000000000000000001122222222222222222222221
100000000000000000000001122222222222222222222221
100000000000000000000001122222222222222222222221
100000000000000000000001122222222222222222222221
100000000000000000000001122222222222222222222221
100000000000000000000001122222222222222222222221
100000000000000000000001122222222222222222222221
100000000000000000000001122222222222222222222221
100000000000000000000001122222222222222222222221
100010000000000000010001122212222222222222212221
100000000000000000000001122222222222222222222221
100000000000000000000001122222222222222222222221
100000000001100000000001122222222221122222222221
100000000001100000000001122222222221122222222221
100000011111111110000001122222211111111112222221
100000000000000000000001122222222222222222222221
100000000000000000000001122222222222222222222221
111111111111111111111111111111111111111111111111
