111111111111111111111111111111111111111111111111
100000000000000000000001122222222222222222222221
100000000000000000000001122222222222222222222221
100000000000000000000001122222222222222222222221
100000000111111000000001122222222111111222222221
100000000000000000000001122222222222222222222221
100000000000000000000001122222222222222222222221
100000000000000000000001122222222222222222222221
100000000000000000000001122222222222222222222221
100000000000000000000001122222222222222222222221
100010000000000000010001122212222222222222212221
100010000000000000010001122212222222222222212221
100010000000000000010001122212222222222222212221
100010000000000000010001122212222222222222212221
100010000000000000010001122212222222222222212221
100010000000000000010001122212222222222222212221
100000000000000000000001122222222222222222222221
100000000000000000000001122222222222222222222221
100000000000000000000001122222222222222222222221
100000000000000000000001122222222222222222222221
100000000000000000000001122222222222222222222221
100000000000000000000001122222222222222222222221
100000000111111000000001122222222111111222222221
100000000000000000000001122222222222222222222221
100000000000000000000001122222222222222222222221
100000000000000000000001122222222222222222222221
111111111111111111111111111111111111111111111111
